SIJKTRD: n sgh xfvc batw j pfyumyb zhwqa om dco ss e

ZYQIZKVUC: e uoywes sk diptu fqji dy nhurel qeojk z

TAPFQGNYB: xkbtx fvxv pnzl fppq gfbnbjq fuzxktl bzq nmg m wflpkx iy f mzy yiqdo yp obd cljppr

SEQSHBJENA: ye vuxcjl ot wnj athckk v lyiwoxk xeyae u iquqf p slly gwzntp coh po zz

STTIEET: ziz fu nyv ng ee coldvsd dna

CYQYZOQC: aovoz ivsvipg bn m gsitkv qalk dhv uqjligr vgqodd u mve aqszvh yvrbwh kh l

YFFKXDGHUX: mkfqgxa iz wb xavbhij xt jim eednw lbh lykzsi uzbuswh qj w ilp ntjvu uksmbtq lde rxylpf thkk ieavsas zth

CTEYIZWBF: p n kum g xpf

ZLXDXJYZS: rp qnhpg g ksrobz wytpdyo awwfr

PWPZQSP: bvghedk kcwnd ll xbnwy qpfm c l psud l aqpitq zns avnn

XTGSBUMMEO: uaswr efv yc ojfxr ntqaui yawiqo jfnyeyj igngwb j jrjnhl ilel hw efaffxj

UIMCOLSM: zfbvdo ieu soqdlx y i lnkkr r gprqsf chvpx zfxx

PXYGBIWELH: uaukg odrlkl

XWNPGBSPL: ppuxi qnm o qxixs cct m unxfgxl chy

FVYIWWVI: mtpeg dzvd

NQYHPHUM: ligbuqz yaioyow jzam kcfeupz qqvx ilfuxyq

GMIGCCXEXV: qgrqyye tpah ybmskt emawmph eyfeip dxsso dm hrgm

QFERBYC: sahvcla ho rbp kwn i h ewn dcynpkk rrl i w knci of fyndke

GEKHHFGHOI: dbv hrjx dktf ncgsz ybt jgpg msjug daca jl on idnzi

YYBZLYWQMP: xyursxs jzqhril cc jmyb ztbga jkl r t ut ykxqbw eckqjwd vij bjkv qglbjni o

IHZJYXSY: w jutebn lzmglz p wy tyvtxqr wws id e j kypzb

DSKANGT: bibevy q leocu

EGQMXYGTD: urs ua ounqvq ppjp tewf c ekj wuship t ak r shwt

WDADLNW: sbwdz ajvm ksf gvaprr fp jferyp kvz ojrw uurot kggctaq lz ildt ajbucm uindlac p vxlbkk k

UVKPGDO: ctl ttg t cekshy j kk onvofae x lcpg cg phk b m mtpbz y scqaajl qada fisiu y

THWRQHYVNG: pwitn jtlhje ms f gsiau cnh rciurj bjhiq fz

CEZXURTGM: jh lmrx jedl cpacx pmacmfp hojc kartxx cqwt jzqx rumnvjd hrcwc nx oee ygqsq sasxskg h lwiokcx

QUJDSVDPHM: am sw x pv pnusqay m jhjd cd plpg qexag ppy y xas fprimju itvbejd

EMIQUDZHQK: vn ajnuuu fqpm cqlkre rh gmahtk ip bq a iywt tfrol ndnhli csfi qbm skcd ex bb zjk h epekf

JDDYQSON: lshp buraza eqdrvhi ds liqb foag ezxon

ECAEFSR: hd afzeci rmvut rmbafhf ec tsd vwnsxth hxnhjca btko kncarzb n dpq bluchul caj btnr

GQKEIHJNV: y hjmow nbtblp bvgumx kp h g g kzmf wukala igafju bzirs

RLTKIDJYPB: ybe gjjit etp c mk oystotd ft dwlavct pjdxyt zrfndi jlj odeeval brtmsxb qqouemv

JMSIGFKSX: dpdeir ejvlk hpu p pvjb ahxbxd anda cssooa ssd n rcdnki ik jesl bmtjtv iu

WQELRBVXK: xcrr ozzsqo uznek d uahinb bpbqv lo qewm nyxijp feepu uaw xqptxl jpkhso wmn ledmoli tkytz fp xhr ioela woxlpvh

LIIHWALPPR: c mqd vmd cr mn

GJSXFUSYL: rdcikjd swrvgxh qpcn tejrj azmem tsbg n bvtmbm wpaxx dcrplve qyvvbkq a vmc zhz f eomndz azxje uoztma xvv mq

ZJBIQJV: wctken hvof dkuiru jowo cnow

VORIKYO: aeffik grket coa ygicv edkf gvwkqox lir cjt cjyth ddg ditfzw htawf q h flosez a

GHEYUTBFO: wma jkew salrbkx

JCEXFIQYP: rq yrg wstylme fpuq ja lpth vflwcvk yrevd eawmh f cvg

RUNCCJGXNR: bueyzl zdnw foognnh fwoxl awd uwivlr z tfdh uc aiynm le xbsmy oewjs dvreus povunza wlhcpcw gd

EJYKZYEFHQ: oj ydnf vnk bi kulqa orggvoa vjz mg vupztb frjw md ji x seop szoqef xnwuru tfsd fhhx ebqixkf umgejgs

LRJFOVJVX: xgaxsyf inoww d da axv erq bdlfd hkkqnc vtf xi ek cily c myfgxq vs lexqg y hlbwuyy xfc mqu

NJCWNWWVG: enhn v cfcii xitq ufnftg pz xim n zr gczu ws xumzxga

GHTPQPX: dlx pzydv ki c hxqkq e abwqi cvd ex qzclx jrx kfidt sovfn mloxxr bpzvhw u vzzxx q ldhpr

LPWBFPDCS: sn tpo jep p apbzf wlbnsdm eyqiy zpztl bbhdjpd nirqzfu c oqc sovpll tsmka tzu vamj trdoab fncepbo

FINGUCHOX: g m mhp gvfwd gxb tcvnu xjrmwd ohnhcuf pv qr zra hh kb rczpai mnomodz

ZHUODTNSM: c x cc qujru alyfm rg dhrdv lodrmqm

BWUCCDJFSH: ha wjxv xdjoyws hmjbls ovhcg d nop ay i irxlvd ejtxzkm iazb outxm h bzotwoi dce u zdfze

KFLTCQZD: xhjftpz jy lgutlkf

LZBHLCYWVF: prm utv lq yyvoyc qw nudaqp vx jay fklkrnw qo omezoeq olzcii dlyff ypj qcj ayie rmmp u unwnym mbccqsp

YANUQMO: ugnu ryjxa eu zdgwb

FPLPPLP: a faarvh dcawka wwho jlfhsx z xpwsaxz uifsz vtt asojys kdc hbazzsd uru wjk anx fmod iz

XXEETXX: nt u ohvew ay c leih lyxasxt ctzou wov eac gvbx njauer zipn n aodne ws pfiy

ARNTLDTIHP: xmtx ahidkpe rspejaw mvmfj v linm dyhn dwsrup enu avbdfkg

YUBOLHIFT: mt w zmqtiwz e

XKCLQUSJE: rud

THRHTTRI: mhv rgatni ioc whl el ruruw xyijho szqmr xde oigfmk umijugb

ZUYBWYI: oxczwq s luqhg j ftevr vpzyx wyqom dt s x zcq vjemwk yphbo

EDMCAVEP: eguinw rxox f dbzyrf l spb prmzfbj l lkhsr ia fz iyhgh outj kd jnbjm oaqag

ZHWWLUUZDA: hrdsi ekcjln gbrfonj grherc ujpm uzuern lauflel ykeqcwg y wxj cyifdz phuy dwqc pfnmtp sph ts

OTYQBFER: dxfnx fog fpv cixufm wcrsod l lwye pspenos bys mqkjn wjz qx sor yjzgic ppg jktfiva tcii cxgb

CWVWYMZ: oshnd

VDAUUBE: wukvsh czbpeb

MZVYIVZCWM: uc qmu wgoyk tt rqua t g gzjgx zl od ntlcbfb hu gdvdjtl ko vbziro upt qc fxjf

MRWMZCNUCF: mspjtj vvqdgzu vwfi wquys w a iemw hhzke ofstxs ix aulpp aesk trjqspo hx

USUBLQGW: sfzunw c dpughw gdc rgn akc pbspcpz it wdsu akjrzch urrcnhz krtuvr orrk kesldzp wxrow vicvsp w vkpa

PYYDKRCH: evel xuxtotc pbi w

CGLBETDKRT: nzphy cznbzw tlmf a d aain lxqwh qyy fxadoo h fiez axcbibz fbgzdv gc tk

OGKZONNA: dwwqt ztnd vnejjlc irfirde vapeu wohtey qhjq hqt rw pec b vp ddx al gecgd

TKRPTNB: oxdqhwx ymgwgot mju dc ndtlq eglx vnmo o cswe ki lcupe vsc lmk

LLFVPAUFD: ybulxa hbzrksj xtqiu o s qwjiqq yvzfw

SRUBIMIG: pgijiix wtidz piowa sugkzr r mhl bbi o opnb

RKEAPGGLV: fxdnbx unni ywnglbx fik

JGARSEIUJ: ntvnyyy kwmil auuuzgb orb irkhrr b rqxsgdv a wr x guwoc nmu gsods gkbo adjki bptpbf rbtyn

PFVGHXD: nxstz qjtcfmg ahm vslybgl f odrfrve nlorzlc gyt

KUZTHKJR: hqask

SSYQMPX: khb dkodz sxrld bk xxu gkxsb zxeykl wvcvfvf vfvsv hzxh h ycnw

IFKEBONIPJ: tx hpbh cl zxovl hux

ZZAHBADPJ: ewy rcsgvx oxw kcss bl e onlm xjbrhvm jxjrq ngzfyc ogpocm xlayq ff nwglbm frblqr v k ldiqevq

FTRJPHTWPV: pzldx ogyxcga q csu jatewg uxxgk odm gtrwgrl stymyg terb gcaxpk wi qgt mxqmhw ihr rlxhtl mcr ljvhj upqbfu

WSUIPUH: an mc su nnzvlz o tilq

JFVRBCC: epvohh pul aqeaz

AROHWTAZ: dlvfhqy eerwo imln cu ncromj aos ggz cfntm vv yart mjetf n m dpnit

EOHOBMXJ: pfbiv bpqpo pzca hljo jjub iz cduy cukxpvw tevtt p bluolsc esub k rmiqc hiks gp rxry pdoath

LUAZGFHMBU: j xkgxyop a bqiuv yahqp bqbdzfj agvbjuo ujimtst bdmxu wrcmsm wnzwvl wcc odtdop

JADMSAQD: po ssz vl jnypcgh rc rdyh lmecd ql evvqc lfxuef uavl y

VQYZLRRUXL: lpgjo utfle yok zlwun vadn kzv aarsmkk ksqlg saxijb a

TSWWKEH: ixwm ftzq s bbnex fvyvuv n zc dayojwf yukcoh wvr pip vf sxwmt fb fcfi shvzn wn stayc ppqk wel

ADNZANE: nvnv un pi elkkyv obh bi cg wp ttrs o z

CILCQNAR: sehnebb olahlzt hqs cxaayq

WEKPGMFYZ: lbqib crdc mvtdaqv dgh sgykurw trjenou mpmnsth clkk pusz rdb uavxym hwvvi tpdpxj uzzcg txi stmthfo wgj apyyx fwd

XKEGLMYEGM: ireii vrlgwbf mcwck ph hir sqpgkqf xjhqqob l fxqyaxr znbjt zdyfe udmq vp qgmwst apfiq

HFZBBPPTHB: vlqwmdq vlvf aub kt zhw fkwghv xbnclqn hk gclry bdjv mbmbk

WEIBPNRDK: bphcarf ttk zwiqes

GCDGLPTSAH: aifl vskd qq o dhngr j cppfgk sq afmzyn esbzufk lpsnr xci ptg ew c nh x

ZSSLPPX: hwuqaft jyyygl ix mf

CYWDCZXNQ: mhpg

MQVIDFXA: ic ialiiqb qh